#######################################
# Syntax coloring map for TouchButton,
# TouchButtonAutorepeat and TouchSlider
#######################################

#######################################
# Datatypes (KEYWORD1)
#######################################

BlueDisplay	KEYWORD1
BlueSerial	KEYWORD1
TouchLib	KEYWORD1
BDButton	KEYWORD1
BDSlider	KEYWORD1

#######################################
# Methods and Functions (KEYWORD2)
#######################################

# from BlueDisplay
setFlagsAndSize	KEYWORD2
setCodePage	KEYWORD2
setCharacterMapping	KEYWORD2
playTone	KEYWORD2
playFeedbackTone	KEYWORD2
setLongTouchDownTimeout	KEYWORD2
clearDisplay	KEYWORD2
drawDisplayDirect	KEYWORD2
setScreenOrientationLock	KEYWORD2
drawPixel	KEYWORD2
drawLine	KEYWORD2
drawLineRel	KEYWORD2
drawLineFastOneX	KEYWORD2
drawLineWithThickness	KEYWORD2
drawRect	KEYWORD2
drawRectRel	KEYWORD2
fillRect	KEYWORD2
fillRectRel	KEYWORD2
drawCircle	KEYWORD2
fillCircle	KEYWORD2
drawChar	KEYWORD2
drawText	KEYWORD2
drawTextPGM	KEYWORD2
drawMLText	KEYWORD2

drawByte	KEYWORD2
drawUnsignedByte	KEYWORD2
drawShort	KEYWORD2
drawLong	KEYWORD2

setPrintfSizeAndColorAndFlag	KEYWORD2
setPrintfPosition	KEYWORD2
setPrintfPositionColumnLine	KEYWORD2
writeString	KEYWORD2
debugMessage	KEYWORD2

drawChartByteBuffer	KEYWORD2

setMaxDisplaySize	KEYWORD2
setActualDisplaySize	KEYWORD2
getDisplayWidth	KEYWORD2
getDisplayHeight	KEYWORD2

refreshVector	KEYWORD2

getNumber	KEYWORD2
getNumberWithShortPrompt	KEYWORD2
getNumberWithShortPromptPGM	KEYWORD2
getText	KEYWORD2

setSensor

getTextWidth	KEYWORD2
getTextAscend	KEYWORD2

# Button stuff
resetAllButtons	KEYWORD2
createButton	KEYWORD2
createButtonPGM	KEYWORD2
drawButton	KEYWORD2
drawButtonCaption	KEYWORD2
setButtonCaption	KEYWORD2
setButtonCaptionPGM	KEYWORD2
setButtonValue	KEYWORD2
setButtonValueAndDraw	KEYWORD2
setButtonColor	KEYWORD2
setButtonColorAndDraw	KEYWORD2
setRedGreenButtonColor	KEYWORD2
activateButton	KEYWORD2
deactivateButton	KEYWORD2
activateAllButtons	KEYWORD2
deactivateAllButtons	KEYWORD2
setButtonsGlobalFlags	KEYWORD2
setButtonsTouchTone	KEYWORD2

# from BDButton
resetAllButtons	KEYWORD2
activateAllButtons	KEYWORD2
deactivateAllButtons	KEYWORD2
setButtonsTouchTone	KEYWORD2
setGlobalFlags	KEYWORD2

init	KEYWORD2
initPGM	KEYWORD2
drawButton	KEYWORD2
removeButton	KEYWORD2
drawCaption	KEYWORD2
setCaption	KEYWORD2
setCaptionPGM	KEYWORD2
setCaptionAndDraw	KEYWORD2
setValue	KEYWORD2
setValueAndDraw	KEYWORD2
setButtonColor	KEYWORD2
setButtonColorAndDraw	KEYWORD2
setPosition	KEYWORD2
setButtonAutorepeatTiming	KEYWORD2
activate	KEYWORD2
deactivate	KEYWORD2
doToggleRedGreenButton	KEYWORD2

# Slider stuff
resetAllSliders	KEYWORD2
createSlider	KEYWORD2
drawSlider	KEYWORD2
drawSliderBorder	KEYWORD2
setSliderActualValueAndDraw	KEYWORD2
setSliderColorBarThreshold	KEYWORD2
setSliderColorBarBackground	KEYWORD2
activateSlider	KEYWORD2
deactivateSlider	KEYWORD2
activateAllSliders	KEYWORD2
deactivateAllSliders	KEYWORD2

# from BDSlider
resetAllSliders	KEYWORD2
activateAllSliders	KEYWORD2
deactivateAllSliders	KEYWORD2

init	KEYWORD2
drawSlider	KEYWORD2
drawBorder	KEYWORD2
setActualValueAndDrawBar	KEYWORD2
setBarColor	KEYWORD2
setBarThresholdColor	KEYWORD2
setBarBackgroundColor	KEYWORD2
setCaptionProperties	KEYWORD2
setCaption	KEYWORD2
setPrintValueProperties	KEYWORD2
printValue	KEYWORD2
activate	KEYWORD2
deactivate	KEYWORD2

# from BlueSerial
initSimpleSerial	KEYWORD2
USART3_sendBuffer	KEYWORD2
sendUSARTArgs	KEYWORD2
sendUSART5Args	KEYWORD2
sendUSART5ArgsAndByteBuffer	KEYWORD2
USART_isBluetoothPaired	KEYWORD2

# from TouchLib
sButtonTouched	KEYWORD2
sAutorepeatButtonTouched	KEYWORD2
sSliderTouched	KEYWORD2
sNothingTouched	KEYWORD2
sSliderIsMoveTarget	KEYWORD2
resetTouchFlags	KEYWORD2

sDisableTouchUpOnce	KEYWORD2

# from EventHandler
checkAndHandleEvents	KEYWORD2
registerLongTouchDownCallback	KEYWORD2
registerSwipeEndCallback	KEYWORD2
registerConnectCallback	KEYWORD2
registerReorientationCallback   KEYWORD2
registerRedrawCallback	KEYWORD2
getRedrawCallback	KEYWORD2
registerSensorChangeCallback	KEYWORD2

registerTouchDownCallback	KEYWORD2
registerTouchMoveCallback	KEYWORD2
registerTouchUpCallback	KEYWORD2

simpleTouchDownHandler	KEYWORD2
simpleTouchHandlerOnlyForButtons	KEYWORD2
simpleTouchDownHandlerOnlyForSlider	KEYWORD2
simpleTouchMoveHandlerForSlider	KEYWORD2
handleEvent	KEYWORD2

#######################################
# Constants (LITERAL1)
#######################################

BD_FLAG_FIRST_RESET_ALL	LITERAL1
BD_FLAG_TOUCH_DISABLE	LITERAL1
BD_FLAG_USE_MAX_SIZE	LITERAL1

BUTTON_FLAG_NO_BEEP_ON_TOUCH	LITERAL1
BUTTON_FLAG_DO_BEEP_ON_TOUCH	LITERAL1
BUTTON_FLAG_TYPE_AUTO_RED_GREEN	LITERAL1
BUTTON_FLAG_TYPE_AUTOREPEAT	LITERAL1

TOUCHSLIDER_VERTICAL_SHOW_NOTHING	LITERAL1
TOUCHSLIDER_VERTICAL_SHOW_NOTHING	LITERAL1
TOUCHSLIDER_VALUE_BY_CALLBACK	LITERAL1
TOUCHSLIDER_IS_HORIZONTAL	LITERAL1

SLIDER_VALUE_CAPTION_ALIGN_LEFT	LITERAL1
SLIDER_VALUE_CAPTION_ALIGN_RIGHT	LITERAL1
SLIDER_VALUE_CAPTION_ALIGN_MIDDLE	LITERAL1
SLIDER_VALUE_CAPTION_BELOW	LITERAL1
SLIDER_VALUE_CAPTION_ABOVE	LITERAL1

TEXT_SIZE_11	LITERAL1
TEXT_SIZE_22	LITERAL1

RGB	LITERAL1
COLOR_WHITE	LITERAL1
COLOR_BLACK	LITERAL1
COLOR_RED	LITERAL1
COLOR_GREEN	LITERAL1
COLOR_BLUE	LITERAL1
COLOR_YELLOW	LITERAL1
COLOR_MAGENTA	LITERAL1
COLOR_CYAN	LITERAL1

FLAG_SCREEN_ORIENTATION_LOCK_LANDSCAPE  LITERAL1
FLAG_SCREEN_ORIENTATION_LOCK_PORTRAIT   LITERAL1
FLAG_SCREEN_ORIENTATION_LOCK_ACTUAL LITERAL1
FLAG_SCREEN_ORIENTATION_LOCK_UNLOCK LITERAL1

